Warm Up,Walk,Run,Cool Down
30,6,9,6,9,6,9,6,9,6,9,6,9,6,9,6,9,30
300,60,90,60,90,60,90,60,90,60,90,60,90,60,90,60,90,300
300,60,90,60,90,60,90,60,90,60,90,60,90,60,90,60,90,300
300,90,120,90,120,90,120,90,120,90,120,90,120,300
300,90,120,90,120,90,120,90,120,90,120,90,120,300
300,90,120,90,120,90,120,90,120,90,120,90,120,300
300,90,90,180,180,90,90,180,180,300
300,90,90,180,180,90,90,180,180,300
300,90,90,180,180,90,90,180,180,300
300,180,90,300,150,180,90,300
300,180,90,300,150,180,90,300
300,180,90,300,150,180,90,300
300,300,180,300,180,300,300
300,480,300,480,300
300,1200,300
300,180,480,180,300,300
300,600,180,600,300
300,1320,300
300,1500,300
300,1500,300
300,1500,300
300,1680,300
300,1680,300
300,1680,300
300,1800,300
300,1800,300
300,1800,300